F 255,0,0
C 0,255,0


NO ./textures/feu.xpm
SO ./textures/eau.xpm
WE ./textures/plante.xpm
EA ./textures/electrik.xpm

T1 ./textures/broly.xpm
T2 ./textures/south.xpm

        1111111111111111111111111
        1000000000110000000000001
        1011000001110000000000001
        1001000000000000000000001
111111111011000001110000000000001
100000000011000001110111111111111
11110111111111011100000010X01
1111D1D11111111011101010000001
11000000110101D11100000010001
10000000000000001100000010001
10000000000000001100000010001
10000000000000001100000010001
10000000000000001100000010001
10000000000000001100000010001
10000000000000001100000010001
10000000000000001100000010001
10000000000000001100000010001
10000000000000001100000010001
10000000000000001100000010001
10000000000000001100000010001
10000000000000001100000010001
10000000000000001100000010001
10000000000000001100000010001
10000000000000001100000010001
10000000000000001100000010001
10000000000000001100000010001
10000000000000001100000010001
10000000000000001100000010001
10000000000000001100000010001
10000000000000001100000010001
10000000000000001100000010001
10000000000000001100000010001
10000000000000001100000010001
10000000000000001100000010001
10000000000000001100000010001
10000000000000001100000010001
10000000000000001100000010001
10000000000000001100000010001
10000000000000001100000010001
10000000000000001100000010001
10000000000000001100000010001
10000000000000000001010010001 
11000001110101011111011110N0111
11110111 1110101 101111010001
11111111 1111111 111111111111
