F 150,200,150
C 150,100,250


NO ./textures/briquewall.xpm
SO ./textures/whitewall.xpm
WE ./textures/forestspirit.xpm
EA ./textures/eau.xpm

T1 ./textures/ghost1vert.xpm
T2 ./textures/ghost2vert.xpm

        1111111111111111111111111
        1000000000110000000000001
        1011000001110000000000001
        1001000000000000000000001
111111111011000001110000000000001
10000000001100000111D111111111111
11110111111111011100000010001
1111D1D11111111011101010D00001
11000000110101D111000000100X1
10000000000000001100000010001
1000000000000000110000001X001
100X0000000000X0110X0000100X1
100X0000000000001100000010001
10000000000000001100000010001
100000X00000000011000X00D0001
10000000000000000001010010001 
11000001110101011111011110N0111
11110111 1110101 101111010001
11111111 1111111 111111111111
